111111111111111111111111111111111111
111111111111111111111111111111111111
110000000100000100000000000000000011
110000000000000100000000000000000011
110111111111111100000000000000000011
110000000001000100000000000000000011
110000000001111100000000000000000011
110000000000000000000000000000000011
110000000001111100000000000000000011
110000000001000000000000000000000011
111111111111000000000000000000000011
110000000000000000000000000000000011
110000000000000000000000000000000011
110000000000000000222220222220000011
110000000000000000230000000320000011
110000000000000000240000000420000011
110000000000000000230000000320000011
110000000000000000222222222220000011
110000000000000000000000000000000011
110000000000000000000000000000000011
110000000000000000000000000000000011
110000000000000000000000000000000011
110000000000000000000000000000000011
110000000000000000000000000000000011
111111111111111111111111111111111111
111111111111111111111111111111111111